


Как вас зовут?	Меня зовут Людмила.		
Фамилия и отчество, пожалуйста.	Даниленко Людмила Васильевна.	
А где вы родились?	Я родилась в Волгоградской области.  В восемьдесят-втором, с тысяча девятьсот восемдесят второго года я проживаю в Санкт Петербурге		 
Вы помните первый раз когда вы ходили в кино?	Это было очень давно.  Может быть, мне было лет пять.		  
Вы помните фильм, на который вы ходили?	Эта была сказка.		
Опишите фильм, пожалуйста.	Впечатление о просмотренном фильме или сюжет?	 	
О посещениях.	Ощущение.  Это было так давно ... Конечно.  Первый большой экран в кинотеатре для меня было что-то необыкновенное.  Как и сам фильм сказка это такое представление у ребёнка, что жизнь вся сказка, такая красивая.  Вот такие первые впечатления.		  ,     ; ,   
С кем вы ходили?	С мамой		
Как вам нравится кинотеатр?	Ну, в современном кинотеатре, я не была, не ... Кино, потому что в связи с работой, с занятостью, нет времени посещать.  А первое впечатление, такой огромный дом с большими креслами, такое приятное что-то новое, это не собственный дом. Тогда ещё у нас телевизора не было, мы не знали что, что такое.  Ну, конечно, очень приятно.		
Когда вы начали ходить в кинотеатр сама?	Это, ну как, одна я не ходила, только где-то лет в шестнадцать, когда мне было шестнадцать лет. Наверно. Тогда, только. А так мы посещали коллективно кинотеатр. Со школой. Или у нас в школе был показ у нас кинозал небольшой был. Нам там показывали или с группой мы ходили в кинотеатр. 		
Вам нравилось ходить в кино?	Конечно нравилось. 		
Как часто вы ходили в кино?	Не очень часто. Может быть один раз в месяц или один раз в два месяца...потому что это тоже такое дорогое удовольствие было.		  …
Κак посещения кино изменилось, когда вы выросли?	Значительно изменилось.  Когда я была ребёнком и когда я стала подростком потом уже взрослым человеком ... Раньше оно, такое было более доступное кино к народу, и для народа было доступным.  Такое оно более жизненное было, нежели сейчас.  Сейчас такие фильмы как Блокбастеры, всё очень странное и много непонятное.	
Какие были ваши самые любимые жанры в детстве?	В дестве, я думаю это вот сказки и такие познавательные.  "В мире животных" мне нравилось, а такая у нас передача была, и много много показывали документальные фильмы.  	
У вас есть любимый фильм?	Наша классика. Но не один я думаю что, очень...много фильмы, Гайдая, "Брильянтовая Рука"..и другие.		  , , Гайдай, "," 
Опишите о фильме, пожалуйста.	Это кинокомедии. Они стали классикой или "Иван Васильевич Меняет Профессию".  Вы тоже наверное знаете. Они очень интересные и они очень жизненные.	
У вас были любимые актёры и актрисы? 	Да конечно. Они были и остались, хотя их уже нет в живых. Евгений Леонов.		
Почему они были ваши любимые актёры?	Я не знаю как, глядя на них в кино, ты, может быть, как переживал с ними вместе ту роль, которую они исполняли очень интересным было, как они играли. 		
Вы помните какой-нибудь фильм или посещение кино особенно?	Еще раз? Это давно, когда было. Я не знаю. Много разных фильмов и классика и военные фильмы. Очень нравились в детстве . У нас такие "Неуловимые Мстители" это революционый фильм. Там роли исполняли мальчики. Девочка и мальчики. Очень нравился мне.		       
А Почему?	Я не знаю. Может быть такие там приключенческие сюжеты у них...примерно одинокового возраста мы были.		
Вы помните какое-нибудь посещение на телевизору, кино по телевизору?	Но...первый фильм...нет...да...Первый фильм наверно я не помню, а помню балет по телевизору Лебединое Озеро, я смотрела.  Это что-то необыкновенное было.  Очень, очень красиво.  Музыка мне нравилась в этом спектакле.  И очень нравились девушки, которые исполняли.  Тогда я очень маленькая была.  Первый раз я увидела.  Они в очень красивых платьях, в пачках ... все белые, необыкновенные.  Вот, это наверно такое яркое впечатление произвело на меня.  Балет очень, очень понравился.		  , ………', , ""    ,     ,     ..,   '  
Вы помните, когда вы посмотрели?	Это было, наверно, 1959ый год.
Как вы проводили свободное время, кроме посещения кино?	Ну, у нас очень много.  Я жила...как можно сказать..такой, маленький посёлок, как в деревне.  Но у нас очень много было занятий по дому, работы.  Мы помогали родителям. У нас много животных было. Мы ухаживали за ними. Кормили. Книги читали.  Вот, у нас летом были каникулы.  После школы, три месяца мы одыхали. Ну и нам обязательно в школе давали большое задание, чтобы мы за лето прочитали много книг.  Ну, так, мне очень нравилось читать.	
С кем вы обычно ходили в кино?  	Ну, когда была маленькая с мамой или со старшей сестрой и с братом. А потом уже ходила с подругами.		 
Было больше мужчин или женшин в кинотеатре?	Нет, наверно, одинаково. 
Люди часто ходили кино с семьёй или с друзьями/подругами?	Я не знаю. Как сказать, по разному бывало, может быть один раз там с друзьями ходили, другой раз с семьями ходили. Родители с детьми.	
В кинотеатр были очереди?	Да, были очереди. 		
Вы помните, когда вы ждали в очереди?	Какое кино?  Я помню в Волгограде я училась, и мы ходили с подругой.  Кино называлось "Женщина, которая поёт". В этом фильме снималась наша знаменитая певица Алла Борисовна Пугачёва.		 ,  ""  
Почему вам понравилось?	Ну, как она становилась известной певицей и вышел новый фильм. Нам очень хотелось посмотреть и услышать новые песни и посмотреть ее не как певицу, а как актрису.		,  , 
Вы знали людей, которые работали в кинотеатре?	В кинотеатре, наверное, нет.
Какая была атмосфера в кинотеатре?	Как в кинозале? Как себя вели дети, кто приходил в кино? Когда как там смотреть когда какой шел фильм кричали, хлопали. Но когда спокойно. Кто-то плакал. Какой сюжет в кино был. Если там грустный. Когда смешно, все смеялись. 		 ,  ,  ,    , 
Вы ели что-нибудь в кинотеатре?	Нет. Я считаю что, это неприлично. Если человек пришел смотреть фильм, значит все внимание его должно быть приковано только к экрану, и он должен смотреть, а не кушать. Для этого есть другое место. 		,  ,  ,  
Но был буфет в кинотеатре?	Да.		
Другие люди ели?	Ну иногда. 		
Что они ели?	Ну что там. Пироги, бутерброды. Что продавалось. Лимонад, как у вас кока кола, пепси кола, у нас лимонад. 		
А мороженое?	Ну мороженое, у нас не было. Это так в городе только было, у нас иногда только привозили мороженое. В магазин. 		
Вы посмотрели иностранные фильмы?	Иностранный, да смотрела иностранные фильмы. Ну, как сейчас наши новые фильмы, мне очень мало нравятся иностранные фильмы. Много каких-то там насилия и убийств. Ну, может быть, такой, я не знаю. Мне , как то, близко старое наше кино. Мы воспитаны на патриотических фильмах, на сказках, как то. Ну, есть очень хорошие иностранные фильмы, я не говорю что там всё полностью кино там американское, французское, нет. Есть очень хорошие фильмы. Я с удовольствием смотрю их. 		
Вы помните какой нибудь фильм вы посмотрели? Иностранные.	Я могу сказать "Спартак", "Троя", но я не помню ни режиссеров, ни актёров. "Александр" есть. "роя". Ну может быть еще другие, ну так исторические, конечно, очень такие эффектные фильмы. 		
Вам нравилось исторический фильм?	Да. Очень хорошие. "Гладиатор", хотя в этих фильмах, конечно, очень много тоже таких сюжетов трагических. Ну фильмы очень интересные. 		 
Когда вы посмотрели это фильм?	Это в прошлом году я смотрела.		
А Спартак тоже?	Да.		
А какие фильме вам нравились больше всего? Иностранный фильм.	Есть и комедии иностранные. С Луи де Фюнесом, мне очень нравятся. Французские фильмы. Где Жан Марэ. Его  уже нет. И один, и другой, они умерли. Ну, фильмы Тимоти Далтон, снимается. Сейчас скажу, я смотрела "Джейн Эйр". Фильм называется "Джейн Эйр". Тимоти Далтон снимается. В этом фильме очень нравится. Он тоже, как история там есть небольшая.	 	
А вам нравится 	Да		
У вас есть любимый иностранный актёр?	Ну, не знаю.  С ом мне нравится.  правило я называла?  Тоже, ну, можно много, много называть есть хороших актёров		
Были ли фильмы, на который вам нельзя было ходить?	Ну, да.  У нас было запрещено до шестнадцати лет нам не разрешали посещать.  Кинотеатр только до четырёх часов.  И там тольло показывали детские фильмы.	
Вам не разрешали ваши родители или администрация кинотеатра?	Ну, и администрация и школа, ну родители тоже, как бы..не разрешали.  До девяти часов мы должны вернуться домой если гуляли.
Да.  Вы попробовали ходить на пойти, на который вам нельзя было пойти?	Пробовали.  Но, нас не пропускали.	 
Вы помните какой-нибудь фильм, у которого были проблемы с выходом на экран?	Ну, я не знаю, я не могу этого сказать.  Ну, может быть цензура какие фильмы запрещала.	
Извините?	Раньше было такая комиссия была.  Они, когда фильм был готов, он должен был выйти на широкий экран в кинотеатре, они смотрели и давали разрешения что можно или нет.  Ну, я не знаю.  
Ваши родители ходили в кино?	Ходили когда..ну, очень редко, когда было время.  
Что они смотрели, когда они ходили?	Разные фильмы которые были, также нашу классику, кинокомедии, ну иностранные фильмы..я не могу сказать сейчас названия, потому что я была очень маленькая.  Ну, что было в кинотеатре, старались по возможности посещать кинотеатр смотреть интересовались тоже, чтобы узнать как другая страна живёт.		
Вы ещё ходите в кино?	Мне бы хотелась.  Но если будет время и возможность конечно.  Вот сейчас, когда есть время я смотрю по телевизору.  		'  , 
Как ваши посещения кинотеатров изменились со временем?  И почему?	Ну, в современном кинотеатре, я не была.  Как не знаю сейчас что есть и стерео кино, другие залы, которые раньше были в кинотеатре просто обыкновенный зал с креслами, большой экран.  Конечно первое впечатление когда мы приходили в зал для нас было необыкновенное, очень приятно было.  Я не могу сейчас сравнить, потому что в новом зале я не была.  Вы можете спросить у более молодого поколения.	 	
Когда было последний раз, когда вы ходили в кино? 	Ой, последний раз, да?  Ну, лет десять назад.   
Это всё.  Спасибо за интервью.	Пожалуйста.	